         NO             ./path_to_the_north_texture  asdlfkajsdflkjf
SO         ./path_to_the_south_texture
             WE           ./path_to_the_west_texture    

EA       ./path_to_the_west_texture 
C 0,        30,1
F 1,0,               


      111111    11
111111         11
1111101         1
10000001       1S1
1001010001      1
11111111     






